11111111111111111111
10000000000000000001
10000C00000E00000001
10000000000000000001
10000000P00000000001
10000000000000000001
10000000000000000001
11111111111111111111