1111111111
100C000C01
10E000P001
1111111111