1111111111
100C000E01
100P100001
1111111111