1111111111
100E000001
10000000P1
100C000001
1111111111